1	1	1	1	1	1	1	1	1	1	1	1	1	1	1	1	1	1	1	1	1	1	1	1	1	1	1	1	1	3	1	1	1	1	1	1	1	1	1	1
9	2	2	0	2	0	0	0	2	0	0	0	0	0	0	0	0	0	0	0	0	0	0	0	0	0	0	0	0	3	0	0	0	0	0	0	0	0	0	9
9	2	2	3	2	0	5	5	2	0	0	0	0	0	0	0	0	0	0	0	0	0	0	0	0	0	0	0	0	3	0	0	0	0	0	0	0	0	0	9
9	2	2	3	2	2	2	2	2	2	3	0	0	0	0	0	0	0	0	0	0	0	3	0	0	0	0	5	0	3	0	0	0	0	0	3	0	0	0	9
9	3	0	3	0	0	0	0	0	0	3	0	0	0	0	0	0	0	0	0	0	0	3	2	2	2	2	2	2	2	2	2	2	2	2	3	0	0	0	9
9	3	2	2	0	0	0	0	0	0	3	0	0	0	0	0	0	0	0	0	0	0	3	0	0	0	0	0	0	0	0	0	0	0	0	3	0	0	0	9
9	3	0	0	0	0	0	0	0	0	3	0	12  12  12  12  12  12  0	0	0	0	3	0	0	0	0	0	0	0	0	0	0	0	0	3	0	0	0	9
9	3	2	2	2	2	2	2	2	2	2	2	2	0	0	0	0	2	2	2	2	2	2	2	2	0	0	0	0	0	0	0	0	0	0	3	0	0	0	9
9	3	0	0	0	0	0	0	0	0	0	0	0	0	0	0	0	0	0	0	0	0	0	0	0	0	0	0	0	0	0	2	2	2	2	3	2	2	2	9
9	3	0	0	0	0	0	0	0	0	0	0	0	0	0	0	0	0	0	0	0	0	0	0	0	0	0	0	0	0	0	0	0	0	0	3	0	0	0	9
9	3	0	5	3	12	12	12	12	12	12	12	12	12	12	12	12	12	12	12	12	12	12	12	3   0	0	0	0	0	0	0	0	0	0	3	0	0	0	9
9	2	2	2	3	2	0	0	0	0	0	0	0	0	0	0	0	0	0	0	0	0	0	2	3	2	2	0	3	0	0	0	0	0	0	3	0	0	0	9
9	2	2	2	3	0	0	0	0	0	0	0	0	3	0	0	0	0	0	0	0	0	0	0	3	2	2	0	3	2	2	2	2	2	2	2	2	2	0	9
9	2	2	2	2	2	2	2	2	2	2	0	0	3	0	0	0	2	2	2	2	0	0	0	3	2	2	0	3	0	0	0	0	0	0	0	0	0	0	9
9	0	0	0	0	0	0	0	0	0	0	0	0	3	0	0	0	0	0	0	0	0	0	0	3	2	2	0	3	0	0	0	0	0	0	0	0	0	0	9
9	0	0	0	0	0	0	0	0	0	0	0	0	3	0	0	0	0	0	0	0	0	0	0	3	2	2	0	3	0	0	0	0	0	0	0	0	0	0	9
9	0	0	0	0	0	0	0	0	0	0	2	2	3	2	2	2	2	2	2	2	2	2	2	2	2	2	0	3	0	0	0	0	0	0	0	0	2	2	9
9	0	0	0	0	0	0	0	0	0	0	0	0	3	0	0	0	0	0	0	0	0	0	0	0	0	0	0	3	0	0	0	0	0	0	0	0	2	3	9
9	0	0	0	0	0	0	0	0	0	5	5	0	3	0	0	12	12	12	12	12	12	0	3	0	0	0	0	3	2	2	2	2	2	2	2	2	2	3	9
9	2	2	0	0	0	2	2	2	2	2	2	2	3	2	2	2	0	0	0	0	2	2	3	0	0	0	0	3	0	0	0	0	0	0	2	0	0	3	9
9	3	2	0	0	0	2	0	0	0	0	0	0	3	0	0	0	0	0	3	0	0	0	3	0	0	0	0	3	0	3	0	0	0	0	2	0	0	3	9
9	3	2	2	2	2	2	0	0	0	0	0	0	3	0	0	0	0	0	3	2	2	2	2	2	2	2	2	2	2	3	2	2	0	0	2	5	5	3	9
9	3	0	0	0	0	2	0	3	0	0	0	0	3	0	0	0	0	0	3	0	0	0	0	0	0	0	0	0	0	3	0	0	0	0	2	2	2	2	9
9	3	5	5	5	0	2	0	3	2	2	2	2	2	2	2	2	0	0	3	0	0	0	0	0	0	0	0	0	0	3	0	0	0	0	0	0	0	0	9
9	2	2	2	2	2	2	0	3	0	0	0	0	0	0	0	0	0	0	3	0	0	0	0	0	0	0	0	2	2	2	2	2	2	2	2	2	2	2	9
9	0	0	2	2	2	2	0	3	0	0	0	0	0	0	0	0	0	0	3	0	0	0	0	0	0	0	0	0	0	0	0	0	0	0	0	0	0	2	9
9	0	0	0	0	0	0	0	3	0	0	0	0	0	0	0	0	0	0	3	0	0	0	0	0	0	0	0	0	0	0	0	0	0	0	0	0	0	2	9
9	0	0	0	0	0	0	0	3	0	0	0	0	0	0	0	0	0	0	3	0	0	0	0	0	0	0	0	0	0	0	0	0	0	0	0	0	0	2	9
9	6	0	0	0	0	0	0	3	0	0	0	0	0	0	0	0	0	0	3	0	0	0	0	0	0	0	0	0	0	0	0	0	5	5	0	0	0	2	9
9	2	2	2	2	2	2	2	2	2	2	2	2	2	2	2	2	2	2	2	2	2	2	2	2	2	2	2	2	2	2	2	2	2	2	2	2	2	2	9