1	1	1	1	1	1	1	1	1	1	1	1	1	1	1	1	1	1	1	1	1	1	1	1	1	1	1	1	1	1	1	1	1	1
9	0	0	0	0	0	0	0	0	3	0	20	0	0	0	0	0	0	0	0	0	0	0	0	0	0	0	0	0	0	0	0	0	9
9	0	0	0	0	0	0	0	0	3	0	0	0	0	0	0	0	0	0	0	0	0	21	0	0	0	0	0	0	0	0	0	0	9
9	0	0	0	0	0	0	0	0	3	0	4	0	0	5	0	0	0	0	4	0	0	0	0	0	0	0	0	0	0	0	0	0	9
9	0	0	0	0	0	0	0	0	2	2	2	2	2	3	2	2	2	2	2	2	2	2	2	2	3	0	0	0	0	0	0	0	9
9	0	0	0	0	0	0	0	0	0	0	0	0	0	3	0	0	0	0	0	0	0	0	0	0	3	0	0	0	0	0	0	0	9
9	0	0	0	0	0	0	0	0	0	0	0	0	0	3	0	0	0	0	0	0	0	0	0	0	3	0	20	0	0	0	0	0	9
9	0	0	0	0	0	0	0	0	0	5	4	0	0	3	0	0	0	0	0	0	0	5	0	0	3	4	0	0	0	0	0	0	9
9	0	0	0	0	0	2	2	2	2	3	2	2	2	2	2	2	0	0	0	0	0	2	2	2	3	2	2	2	2	0	0	0	9
9	0	0	0	0	0	0	0	0	0	3	0	0	0	0	0	3	0	0	0	0	0	0	0	0	3	0	0	0	0	0	0	0	9
9	0	0	0	0	0	0	0	0	0	3	0	0	0	0	0	3	0	0	0	0	0	0	20	0	3	0	0	0	0	0	0	0	9
9	0	0	0	0	0	0	0	0	5	3	0	0	0	0	0	3	0	0	5	0	4	0	0	0	3	0	0	0	0	0	0	0	9
9	0	0	0	0	0	0	0	3	2	2	0	0	0	0	0	2	2	2	2	2	2	2	2	2	2	0	0	0	0	0	0	0	9
9	0	0	0	0	0	0	0	3	0	0	0	0	0	0	0	0	0	0	0	0	0	0	0	0	0	0	0	0	0	0	0	0	9
9	0	2 2 2 2	0	0	3	0	0	0	0	0	0	0	0	0	0	0	0	0	0	0	0	0	0	0	0	0	0	0	0	9
9	0	0	0	0	0	0	0	3	0	0	0	0	0	6	0	0	0	5	0	0	0	0	4	0	0	0	0	0	0	0	0	0	9
9	0	0	0	0	0	0	2	2	2	2	2	2	2	2	2	2	2	2	2	2	2	2	2	2	2	2	2	2	2	2	2	2	9
1	1	1	1	1	1	1	1	1	1	1	1	1	1	1	1	1	1	1	1	1	1	1	1	1	1	1	1	1	1	1	1	1	1
