111111111
900000009
900000009
922232229
900030009
900030009
922222229
111111111