1	1	1	1	1	1	1	1	1	1	1	1	1	1	1	1	1	1	1	1	1	1	1	1	1	1	1	1	1	1	1	1	1	1	1	1	15	1	1	1
9	0	0	0	0	4	0	0	0	0	0	0	0	0	4	0	0	0	0	0	0	0	12	12	12	12	12	12	0	0	0	0	0	0	0	0	3	0	0	9
9	0	0	0	2	2	2	0	2	0	0	2	0	2	2	2	0	0	2	2	0	0	2	0	0	0	0	2	2	2	0	0	0	0	0	0	3	0	0	9
9	0	0	0	0	2	0	0	2	2	0	2	0	2	0	0	0	2	0	0	2	0	2	0	0	0	0	2	0	0	2	0	0	0	0	0	3	0	0	9
9	0	0	0	0	2	0	0	2	2	0	2	0	2	0	0	0	2	0	0	2	0	2	0	0	0	0	2	4	0	2	0	0	0	0	0	3	0	0	9
9	0	0	0	0	2	0	0	2	0	2	2	0	2	2	0	0	2	0	0	2	0	2	0	2	0	0	2	2	2	0	0	0	0	0	0	3	0	0	9
9	0	0	0	0	2	0	0	2	0	2	2	0	2	0	0	0	2	0	0	2	0	2	2	2	2	0	2	0	0	2	0	0	0	0	0	3	0	0	9
9	0	0	0	0	2	0	0	2	0	0	2	0	2	0	0	0	2	0	0	2	0	0	0	2	0	0	2	0	0	2	0	0	0	3	0	3	0	0	9
9	0	0	0	2	2	2	0	2	0	0	2	0	2	0	0	0	0	2	2	0	0	0	0	2	0	0	2	2	2	0	0	2	2	3	2	2	2	0	9
9	0	12	12	12	12	12	12	12	12	12	12	12	12	12	12	12	12	12	12	12	12	12	12	12	12	12	12	3	0	0	0	0	0	3	0	0	0	0	9
9	0	0	0	0	0	0	0	0	4	0	0	0	0	0	0	0	0	0	0	0	0	4	0	0	0	0	0	3	5	0	3	0	0	3	0	0	0	0	9
9	0	0	0	0	0	0	0	0	2	0	0	0	3	5	0	0	0	2	0	0	2	2	2	2	2	2	0	2	2	2	3	0	0	3	0	0	0	0	9
9	0	0	0	0	0	0	0	0	2	0	0	2	3	2	2	0	0	2	0	0	2	0	0	0	0	2	2	0	0	0	3	3	0	3	0	0	0	0	9
9	0	0	0	0	0	0	0	0	2	0	0	0	3	0	0	0	0	2	0	0	2	0	0	3	0	0	2	0	0	0	2	3	0	3	0	0	0	0	9
9	0	0	0	0	0	3	0	0	2	0	0	0	3	0	0	0	0	2	0	0	2	0	0	3	0	0	2	0	0	0	0	3	0	3	0	5	0	13	9
9	0	0	0	0	0	3	12	12	12	12	12	0	3	0	12	12	12	12	12	12	12	12	12	3	0	4	2	0	0	0	0	2	2	2	2	2	2	2	9
9	0	0	0	0	0	3	0	0	2	0	0	2	2	2	2	0	0	2	0	0	2	0	5	3	0	2	2	0	0	0	0	0	0	0	0	0	0	0	9
9	0	0	3	0	0	3	0	0	2	0	0	0	0	0	0	0	0	2	0	0	2	2	2	2	2	2	0	0	0	0	0	0	0	0	0	0	0	0	9
9	0	2	3	2	2	2	2	0	2	0	0	0	0	0	0	0	0	2	0	0	2	0	0	0	0	2	2	0	0	0	0	0	0	0	0	0	0	0	9
9	0	0	3	0	0	0	0	0	2	0	0	0	0	0	0	0	0	2	0	0	2	0	0	0	0	0	2	2	0	0	0	0	0	0	0	0	0	0	9
9	0	0	3	0	0	0	0	0	2	0	0	0	0	0	0	0	0	2	0	0	2	0	0	0	0	0	0	2	2	0	0	0	0	0	0	0	0	0	9
9	0	0	3	0	0	0	0	0	2	4	0	0	0	0	0	0	0	2	0	0	2	0	0	0	0	0	0	0	2	0	0	0	0	0	0	0	0	0	9
9	0	0	3	0	0	0	0	0	2	2	0	0	3	0	0	0	2	2	0	0	2	0	0	0	0	0	0	4	2	0	0	0	0	0	0	0	0	0	9
9	0	0	3	0	0	0	0	0	0	2	2	0	3	0	0	2	2	0	0	0	2	0	0	0	0	0	0	2	2	0	0	0	0	0	0	0	0	0	9
9	0	0	3	0	0	0	0	0	0	0	2	2	3	0	2	2	0	0	0	0	2	4	0	3	0	0	2	2	0	0	0	0	0	0	0	0	0	0	9
9	0	0	3	0	0	0	0	0	0	0	0	2	3	2	2	0	0	0	0	0	2	2	2	3	2	2	2	0	0	0	0	0	0	0	0	0	0	0	9
9	0	0	3	0	0	0	0	0	0	0	0	0	3	0	0	0	0	0	0	0	0	0	0	3	0	0	0	0	0	0	0	0	0	0	0	0	0	0	9
9	0	0	3	0	0	0	6	0	0	0	0	0	3	0	0	0	0	0	0	0	0	0	0	3	0	0	0	0	0	0	0	0	4	0	4	0	4	0	9
9	2	2	2	2	2	2	2	2	2	2	2	2	2	2	2	2	2	2	2	2	2	2	2	2	2	2	2	2	2	2	2	2	2	2	2	2	2	2	9
1	1	1	1	1	1	1	1	1	1	1	1	1	1	1	1	1	1	1	1	1	1	1	1	1	1	1	1	1	1	1	1	1	1	1	1	1	1	1	9
